9
6
######
#...##
###.##
#....#
#.##.#
#.#..#
#.##.#
#....#
#.####
7
49

