9
7
#######
#.#...#
....#.#
#.###.#
..##...
#..#.##
##...##
##.#..#
#####.#
15
61
