10
11
###########
#.........#
##.#.#.##.#
#..##..#...
#.###.##.##
#...#.#...#
#.#...#.#.#
#.###.#.#.#
#.......#.#
#.###.###.#
17
104