9
9
#########
........#
#.##.#.##
.....#.##
#.#.#...#
#.#...#.#
#.##.##.#
#.#.....#
####.##.#
13
76

