11
13
#############
#...........#
#.##.###.#.##
#..#...#.#..#
##.###.#.##.#
#..##..#.#..#
#.##...#.#.##
#..#.#.#.#..#
##.#.#.#.##.#
##...#.......
#############
14
129