8
8
###.####
.......#
#.#.##.#
#.#.#..#
..#.#.##
#...#...
#.#...##
#.######
14
47

