10
10
##########
#.......##
#.#####..#
#.#...#.##
#.#.#.#.##
#...#...##
#.###.#.##
#.#...#.##
#...#.....
###.###.##
11
97

