6
5
#####
#...#
#.#.#
#.#..
#...#
#####
6
19

