13
12
############
#....#.....#
##.#.#.###.#
##.#.....#.#
##.#######.#
#....#.#...#
#.##.#.#.###
#.##.#.#...#
#.#..#.#.#.#
#.####.#.#.#
#....#.###.#
#.##.#.....#
#.##.#######
#.#........#
#.######.###
66
176