14
13
#.##.###.####
#...........#
###########.#
#........##.#
#.######.##.#
#.######.##.#
#.##.....##.#
#.##.######.#
#.##.######.#
#.#.........#
#.#######.###
#...#####...#
#.#.......###
#.#.#########
84
172