14
13
#############
#.#........##
#.#.######.##
#...######.##
##.#######.##
##.#######.##
##...........
#..####.##.##
##.####.##.##
##.####.##.##
##.#....##.##
.....#####.##
##.#.#####.##
####.#####.##
14
90