15
12
#.##########
#...........
#.#####.####
#.#####.####
#.#####.####
#...........
#.##.#######
#.#..##....#
#.#.###.##.#
#.#.....##.#
#.########.#
#.......##.#
#.###.####..
#.###......#
#.##########
13
155