11
11
###########
..........#
#######.#.#
#.#####.#.#
......#.#.#
###.#.#.#.#
#...#.#.#.#
#.#.#...#.#
#.#.#####.#
#.........#
###########
34
11