13
13
##.##########
##.##########
##...........
##.#.#####.##
##.#...#...##
##.###.#.#.##
##.#.....#.##
##.#.#.###.##
##...#...#.##
##.#####.#.##
...........##
##########.##
##########.##
84
2