12
12
############
##...#.....#
##.#.#.#.#.#
#..#...#.#.#
#.######.#.#
#..#...#.#.#
##.#.#...#.#
#..#.#####.#
#.##.#...#.#
#......#.#.#
#.######...#
#.##########
22
133