10
10
#.###.####
#...#....#
#.#.#.##.#
#.#.#.#..#
#.#.#.#.##
#.#...#...
#.#####.##
#.#.....##
#...###..#
########.#
11
59