15
15
#.#############
#..............
#.##.########.#
#.##.....####.#
#.######.####.#
#.######.####.#
#.######.####.#
#.#.........#.#
#.#.####.##.#.#
#.#.##...##.#.#
#...##.#.##.#.#
###.##.####.#.#
###.##......#.#
#....######....
###############
196
209