14
14
##############
#.##.##.##...#
#.......##.###
#.##.##.##.###
####.#####.###
#............#
#.###.#.####.#
....#.#.####.#
###.#.#.#.##.#
#...###.#.##.#
#.###...#.....
....###.#.####
###.......####
###.##########
32
185