15
12
#.##########
#.....#....#
#.###.#.##.#
#.#.#.#.##.#
#.#...#..#..
#.######.#.#
#...####.#.#
###.#....#.#
#...#.##.#.#
#.###.##.#.#
#.....####.#
########...#
##....##.###
##.##....###
##.#########
13
170