11
13
#.###########
#............
####.######.#
####.######.#
##........#.#
##.######.#.#
##.#...#....#
##...#.##.###
##.#.#.##.###
##.#......###
##.###.######
17
136